SOURCE: https://www.acog.org/womens-health/faqs/dysmenorrhea-painful-periods
CATEGORY: pain_management
AUTHORITY: gold_standard
==================================================
Adenomyosis: A condition in which the tissue that normally lines the uterus begins to grow in the muscle wall of the uterus.
Adhesions: Scars that can make tissue surfaces stick together. 
Biofeedback: A technique used by physical therapists to help a person control body functions, such as heartbeat or blood pressure.
Birth Control: Devices or medications used to prevent pregnancy.
Bladder: A hollow, muscular organ in which urine is stored.
Dysmenorrhea: Discomfort and pain during the menstrual period.
Endometriosis: A condition in which tissue that lines the uterus is found outside of the uterus, usually on the ovaries, fallopian tubes, and other pelvic structures.
Estrogen: A female hormone produced in the ovaries.
Fallopian Tubes: Tubes through which an egg travels from the ovary to the uterus.
Fibroids: Growths that form in the muscle of the uterus. Fibroids usually are noncancerous.
General Anesthesia: The use of drugs that create a sleep-like state to prevent pain during surgery.
Gonadotropin-releasing Hormone (GnRH) Agonists: Medical therapy used to block the effect of certain hormones.
Hormones: Substances made in the body that control the function of cells or organs.
Hysterectomy: Surgery to remove the uterus.
Intrauterine Device (IUD): A small device that is inserted and left inside the uterus to prevent pregnancy.
Laparoscopy: A surgical procedure in which a thin, lighted telescope called a laparoscope is inserted through a small incision (cut) in the abdomen. The laparoscope is used to view the pelvic organs. Other instruments can be used with it to perform surgery.
Menstrual Periods: The monthly shedding of blood and tissue from the uterus.
Menstruation: The monthly shedding of blood and tissue from the uterus that happens when a woman is not pregnant.
Nonsteroidal Anti-Inflammatory Drugs (NSAIDs): Drugs that relieve pain by reducing inflammation. Many types are available over the counter, including ibuprofen and naproxen.
Obstetrician–Gynecologist (Ob-Gyn): A doctor with special training and education in women’s health.
Ovaries: Organs in women that contain the eggs necessary to get pregnant and make important hormones, such as estrogen, progesterone, and testosterone.
Pelvic Exam: A physical examination of a woman’s pelvic organs.
Progestin: A synthetic form of progesterone that is similar to the hormone made naturally by the body.
Prostaglandins: Chemicals that are made by the body that have many effects, including causing the muscle of the uterus to contract, usually causing cramps.
Ultrasound Exam: A test in which sound waves are used to examine inner parts of the body. During pregnancy, ultrasound can be used to check the fetus.
Uterine Artery Embolization (UAE): A procedure to block the blood vessels to the uterus. This procedure is used to stop bleeding after delivery. It is also used to stop other causes of bleeding from the uterus. 
Uterus: A muscular organ in the female pelvis. During pregnancy, this organ holds and nourishes the fetus. Also called the womb.