SOURCE: https://www.acog.org/womens-health/faqs/heavy-menstrual-bleeding
CATEGORY: pain_management
AUTHORITY: gold_standard
==================================================
Adenomyosis: A condition in which the tissue that normally lines the uterus begins to grow in the muscle wall of the uterus.
Birth Control: Devices or medications used to prevent pregnancy.
Cells: The smallest units of a structure in the body. Cells are the building blocks for all parts of the body.
Cervix: The lower, narrow end of the uterus at the top of the vagina.
Complications: Diseases or conditions that happen as a result of another disease or condition. An example is pneumonia that occurs as a result of the flu. A complication also can occur as a result of a condition, such as pregnancy. An example of a pregnancy complication is preterm labor.
Dilation and Curettage (D&C): A procedure that opens the cervix so tissue in the uterus can be removed using an instrument called a curette.
Ectopic Pregnancy: A pregnancy in a place other than the uterus, usually in one of the fallopian tubes.
Endometrial Ablation: A minor surgical procedure in which the lining of the uterus is destroyed to stop or reduce menstrual bleeding.
Endometrial Biopsy: A procedure in which a small amount of the tissue lining the uterus is removed and examined under a microscope.
Endometrial Cancer: Cancer of the lining of the uterus.
Endometriosis: A condition in which tissue that lines the uterus is found outside of the uterus, usually on the ovaries, fallopian tubes, and other pelvic structures.
Endometrium: The lining of the uterus.
Fibroids: Growths that form in the muscle of the uterus. Fibroids usually are noncancerous.
Gonadotropin-releasing Hormone (GnRH) Agonists: A hormone made in the brain that tells the pituitary gland when to produce follicle-stimulating hormone (FSH) and luteinizing hormone.
Hormone Therapy: Treatment in which estrogen and often progestin are taken to help relieve symptoms that may happen around the time of menopause.
Hypothyroidism: A condition in which the thyroid gland makes too little thyroid hormone.
Hysterectomy: Surgery to remove the uterus.
Hysteroscopy: A procedure in which a lighted telescope is inserted into the uterus through the cervix to view the inside of the uterus or perform surgery.
Intrauterine Device (IUD): A small device that is inserted and left inside the uterus to prevent pregnancy.
Iron-Deficiency Anemia: Abnormally low levels of iron in the blood.
Magnetic Resonance Imaging (MRI): A test to view internal organs and structures by using a strong magnetic field and sound waves.
Menopause: The time when a woman’s menstrual periods stop permanently. Menopause is confirmed after 1 year of no periods.
Menstrual Cycle: The monthly process of changes that occur to prepare a woman’s body for possible pregnancy. A menstrual cycle is defined from the first day of menstrual bleeding of one cycle to the first day of menstrual bleeding of the next cycle.
Miscarriage: Loss of a pregnancy that is in the uterus.
Myomectomy: Surgery to uterine fibroids only, leaving the uterus in place.
Nonsteroidal Anti-Inflammatory Drugs (NSAIDs): Drugs that relieve pain by reducing inflammation. Many types are available over the counter, including ibuprofen and naproxen.
Obstetrician–Gynecologist (Ob-Gyn): A doctor with special training and education in women’s health.
Ovulation: The time when an ovary releases an egg. 
Pelvic Exam: A physical examination of a woman’s pelvic organs.
Pelvic Inflammatory Disease (PID): An infection of the upper female genital tract.
Perimenopause: The time period leading up to menopause.
Polycystic Ovary Syndrome (PCOS): A condition that leads to a hormone imbalance that affects a woman’s monthly menstrual periods, ovulation, ability to get pregnant, and metabolism.
Polyps: Abnormal tissue growths that can develop on the inside of an organ.
Progestin: A synthetic form of progesterone that is similar to the hormone made naturally by the body.
Puberty: The stage of life when the reproductive organs start to function and other sex features develop. For women, this is the time when menstrual periods start and the breasts develop.
Sexually Transmitted Infections (STIs): Infections that are spread by sexual contact. Infections include chlamydia, gonorrhea, human papillomavirus (HPV), herpes, syphilis, and human immunodeficiency virus (HIV, the cause of acquired immunodeficiency syndrome [AIDS]).
Sonohysterography: A procedure in which sterile fluid is injected into the uterus through the cervix while ultrasound images are taken of the inside of the uterus.
Sterilization: A permanent method of birth control.
Tranexamic Acid: A medication prescribed to treat or prevent heavy bleeding.
Ultrasound Exam: A test in which sound waves are used to examine inner parts of the body. During pregnancy, ultrasound can be used to check the fetus.
Uterine Artery Embolization: A procedure to block the blood vessels to the uterus. This procedure is used to stop bleeding after delivery. It is also used to stop other causes of bleeding from the uterus.
Uterus: A muscular organ in the female pelvis. During pregnancy, this organ holds and nourishes the fetus. Also called the womb.